{
  "name": "Пещера",
  "width": 20,
  "height": 15,
  "layers": {
    "ground": [
      1,1,1,1,1,1,1,1,1,1,1,1,1,1,1,1,1,1,1,1,
      1,1,1,1,1,1,1,1,1,1,1,1,1,1,1,1,1,1,1,1,
      1,1,1,1,1,1,1,1,1,1,1,1,1,1,1,1,1,1,1,1,
      1,1,1,1,1,1,1,1,1,1,1,1,1,1,1,1,1,1,1,1,
      1,1,1,1,1,1,1,1,1,1,1,1,1,1,1,1,1,1,1,1,
      1,1,1,1,1,1,1,1,1,1,1,1,1,1,1,1,1,1,1,1,
      1,1,1,1,1,1,1,1,1,1,1,1,1,1,1,1,1,1,1,1,
      1,1,1,1,1,1,1,1,1,1,1,1,1,1,1,1,1,1,1,1,
      1,1,1,1,1,1,1,1,1,1,1,1,1,1,1,1,1,1,1,1,
      1,1,1,1,1,1,1,1,1,1,1,1,1,1,1,1,1,1,1,1,
      1,1,1,1,1,1,1,1,1,1,1,1,1,1,1,1,1,1,1,1,
      1,1,1,1,1,1,1,1,1,1,1,1,1,1,1,1,1,1,1,1,
      1,1,1,1,1,1,1,1,1,1,1,1,1,1,1,1,1,1,1,1,
      1,1,1,1,1,1,1,1,1,1,1,1,1,1,1,1,1,1,1,1,
      1,1,1,1,1,1,1,1,1,1,1,1,1,1,1,1,1,1,1,1
    ],
    "collision": [
      1,1,1,1,1,1,1,1,1,1,1,1,1,1,1,1,1,1,1,1,
      1,0,0,0,0,0,0,0,0,0,0,0,0,0,0,0,0,0,0,1,
      1,0,0,0,0,0,0,0,0,0,0,0,0,0,0,0,0,0,0,1,
      1,0,0,0,0,0,0,0,0,0,0,0,0,0,0,0,0,0,0,1,
      1,0,0,0,0,0,0,0,0,0,0,0,0,0,0,0,0,0,0,1,
      1,0,0,0,0,0,0,0,0,0,0,0,0,0,0,0,0,0,0,1,
      1,0,0,0,0,0,0,0,0,0,0,0,0,0,0,0,0,0,0,1,
      1,0,0,0,1,1,1,1,0,0,0,0,0,0,0,0,0,0,0,1,
      1,0,0,0,1,1,1,1,0,0,0,0,0,0,0,0,0,0,0,1,
      1,0,0,0,0,0,0,0,0,0,0,0,0,0,0,0,0,0,0,1,
      1,0,0,0,0,0,0,0,0,0,0,0,0,0,0,0,0,0,0,1,
      1,0,0,0,0,0,0,0,0,0,0,0,0,0,0,0,0,0,0,1,
      1,0,0,0,0,0,0,0,0,0,0,0,0,0,0,0,0,0,0,1,
      1,0,0,0,0,0,0,0,0,0,0,0,0,0,0,0,0,0,0,1,
      1,1,1,1,1,1,1,1,1,1,1,1,1,1,1,1,1,1,1,1
    ]
  },
  "spawn": {
    "x": 3, 
    "y": 7
  },
  "triggers": [
    {
      "rect": [18, 7, 1, 2], 
      "action": "battle", 
      "enemy": "dust_bunny",
      "type": "portal"
    }
  ],
  "npcs": [
    {
      "x": 6,
      "y": 6,
      "dialog_id": "hermit"
    }
  ]
}